#############
#___%___%___#
#_###_###___#
#___%___%___#
#___________#
#___###_____#
#___________#
#___________#
#___%___%___#
#___###_____#
#___________#
#___%___%___#
######B######
