#############
#_____%%%___#
#_____#_____#
#_____#_____#
#___________#
#_____%_____#
#_____#_____#
#_____%_____#
#_____#_____#
#___________#
#_____#_____#
#_____#_____#
######B#####
