___%%%%%%%%%%
_____________
_______##____
%______##____
__%__________
__%__________
__%_________#
__%_________#
__%__________
%%%__________
_____________
%%___%_______
_%__%B%______ 