XXXXXXXXXXXXX
YYYYYYYYYYYYY
ZZZZZZZZZZZZZ
AAAAAAAAAAAAA
BBBBBBBBBBBBB
CCCCCCCCCCCCC
DDDDDDDDDDDDD
EEEEEEEEEEEEE
FFFFFFFFFFFFF
GGGGGGGGGGGGG
HHHHHHHHHHHHH
IIIIIIIIIIIII
JJJJJJJJJJJJJ