____#__%_____
________%__%_
___%___%___#_
_%%________%_
_______#_____
__#_______#__
%___%________
%___________%
_____________
%%%______%%%%
##_________##
_____%_______
____%B%______ 