____#__%_____
________%__%_
___%___%___#_
_%%________%_
_______#_____
__#_______#__
%___%________
%___________%
__________B__
%%%______%%%%
##_________##
_____%_______
___#_________